@@#@@@@@@@@@@@@@@@@@
@ #                @
@ >       K        @
@ @@@@@@@@@@@#@@@@ @
@            #     @
@            #     @
@ @@#@@@@@@@@@@@@@ @
@   #       #      @
@   #       #      @
@G  #   F          @
@@ @@@@@@@@@@@@@@  @
@                 #@
@                 #@
@ @@@#@@@     K   #@
@    #     @@@@@@@@@
@    #             @
@ @@@@@@@@@@@@@@#  @
@               #  @
@B    P         #  @
@@@@@@@@@@@@@@@@@@@@
