@@@@#@@@@@@@@@@@@@@@
@   >              @
@   @@#            @
@             F    @
@       #     @@@# @
@       #@@@     # @
@#@              # @
@#   @    G  K  @# @
@#   @@@@@@@@@@    @
@@@                @
@  #      F       #@
@     @@@@@@@@@@  #@
@                  @
@           F     #@
@        # @@@ #   @
@     #            @
@    F      K   @  @
@  #@@@@@@@@@@@@@ G@
@  #  P  B        @@
@@@@@@@@@@@@@@@@@@@@
