@@@@@@@@@@@@@@@@@#@@
@                # @
@    K           # @
@ #@@@@@         < @
@ #        @@@@@@@ @
@ #       #        @
@ #                @
@ #                @
@ @@@@@@  #        @
@         #        @
@  E    @@@@@@@@#  @
@    @@@        #@@@
@               #  @
@ @@@#@@@      F#  @
@    #     @@@@@@  @
@ K  #             @
@ @@@@@@@@@@@@@@#  @
@               #  @
@B     G        # P@
@@@@@@@@@@@@@@@@@@@@
